11111111111111111111
11P00000000000000011
11000001100011100011
1100001010010E100011
11000111110001000011
11000000100010000011
1100000C1C0111100011
11000000000000000C11
11111111111111111111
