11111111111111111
11111101000001111
11111P01011101111
11110101111011111
11101101110111111
11000001101111111
11111101011111111
111111C00000E1111
11111111111111111
