11111111111
11P11111111
11011111111
11011111111
11011111111
11011111111
11C0000E111
11111111111
