11111111111
11C0P0C0E11
11P11111111
11000C11111
11P11111111
11011111111
11C00000P11
11111111111
