11111111111
11C000C0011
11011111111
11000C11111
11011111111
11011111111
11C00000P11
11111111111
