11111111111
11C000C0E11
11011111111
110E0C11111
11011111111
11011111111
11C00000P11
11111111111
