11111111111
11C000C0E11
11011111111
11000000C11
11111111011
11000000C11
11011111111
11000000P11
11111111111
