1111111111111111111111
111P000111100000001111
1100000001000000000111
1100000000000000000111
1100000000000000000111
1110000000000000001111
1111000000000000011111
1111000000100000C11111
1111100000110000011111
1111100001110000011111
11111000C1110000111111
1111110001110000111111
111111100111E001111111
1111111111111111111111
